000000000000000000000000000000000000000000000000000000000000
121212121212121212121212121212121212121212121212121212121212
121212121212121212121212121212121212121212121212121212121212
121212121212121212121212121212121212121212121212121212121212
121212121212121212121212121212121212121212121212121212121212
121212121212121212121212121212121212121212121212121212121212
121212121212121212121212121212121212121212121212121212121212
121212121212121212121212121212121212121212121212121212121212
121212121212121212121212121212121212121212121212121212121212
121212121212121212121212121212121212121212121212121212121212
121212121212121212121212121212121212121212121212121212121212
121212121212121212121212121212121212121212121212121212121212
121212121212121212121212121212121212121212121212121212121212
121212121212121212121212121212121212121212121212121212121212
121212121212121212121212121212121212121212121212121212121212
121212121212121212121212121212121212121212121212121212121212
121212121212121212121212121212121212121212121212121212121212
121212121212121212121212121212121212121212121212121212121212
121212121212121212121212121212121212121212121212121212121212
121212121212121212121212121212121212121212121212121212121212
121212121212121212121212121212121212121212121212121212121212
121212121212121212121212121212121212121212121212121212121212
121212121212121212121212121212121212121212121212121212121212
121212121212121212121212121212121212121212121212121212121212
121212121212121212121212121212121212121212121212121212121212
121212121212121212121212121212121212121212121212121212121212
121212121212121212121212121212121212121212121212121212121212
121212121212121212121212121212121212121212121212121212121212
121212121212121212121212121212121212121212121212121212121212
121212121212121212121212121212121212121212121212121212121212
121212121212121212121212121212121212121212121212121212121212
111111111111111111111111111111111111111111111111111111111111