000000000000000000000000000000000000000000000000000000000000
1 1212121212121212121212121212121212121212121212121212121212
121212121212121212121212121212121212121212121212121212121212
121212121212121212121212121212121212121212121212121212121212
121212121212121212121212121212121212121212121212121212121212
121212121212121212121212121212121212121212121212121212121212
121212121212121212121212121212121212121212121212121212121212
121212121212121212121212121212121212121212121212121212121212
121212121212121212121212121212121212121212121212121212121212
121212121212121212121212121212121212121212121212121212121212
121212121212121212121212121212121212121212121212121212121212
121212121212121212121212121212121212121212121212121212121212
121212121212121212121212121212121212121212121212121212121212
121212121212121212121212121212121212121212121212121212121212
121212121212121212121212121212121212121212121212121212121212
121212121212121212121212121212121212121212121212121212121212
121212120000000000000000000000000000000000000000000000021212
121212121212121212121212121212121212121212121212121212121212
121212121212121212121212121212121212121212121212121212121212
121212121212121212121212121212121212121212121212121212121212
121212121212121212121212121212121212121212121212121212121212
121212121212121212121212121212121212121212121212121212121212
121212121212121212121212121212121212121212121212121212121212
121212121212121212121212121212121212121212121212121212121212
121212121212121212121212121212121212121212121212121212121212
121212121212121212121212121212121212121212121212121212121212
121212121212121212121212121212121212121212121212121212121212
121212121212121212121212121212121212121212121212121212121212
121212121212121212121212121212121212121212121212121212121212
121212121212121212121212121212121212121212121212121212121212
121212121212121212121212121212121212121212121212121212121212
111111111111111111111111111111111111111111111111111111111111